**********
*     *  * 
*     *  *
*        *
*  *     *
* ** * ***
* *      *
* **     *
*        *
**********