####################
#                  #
#      #####       #
#  [     #         #
#        #         #
#        #         #
#                  #
#                  #
#        #         #
#    #####     #   #
#              #   #
#              #   #
#     ####     #   #
#              #   #
#        #     #   #
#        #         #
#        #         #
#      #####    ]  #
#                  #
####################
